========================================
#     #  ######  #	 #	 #######
#     #  #	 #	 #	 #     #
#######  ######  #	 #	 #     #
#     #  #	 #	 #	 #     #
#     #  ######  ######  ######  #######
========================================

HELLO! HELLO! HELLO! HELLO! HELLO! HELLO!
